{
  "figurePages": {
    "20": 18,
    "51": 14,
    "85": 8,
    "33": 13,
    "74": 40,
    "78": 20,
    "54": 18,
    "13": 13,
    "52": 14,
    "82": 7,
    "81": 7,
    "75": 8,
    "109": 9,
    "70": 14,
    "19": 30,
    "43": 11,
    "95": 9,
    "116": 4,
    "61": 13,
    "92": 9,
    "113": 3,
    "118": 4,
    "17": 12,
    "58": 39,
    "121": 4,
    "1": 3,
    "6": 11,
    "24": 14,
    "112": 6,
    "28": 15,
    "16": 35,
    "21": 15,
    "77": 6,
    "83": 10,
    "119": 39,
    "115": 4,
    "88": 7,
    "90": 8,
    "80": 6,
    "66": 11,
    "86": 7,
    "27": 13,
    "111": 5,
    "14": 14,
    "73": 11,
    "48": 13,
    "15": 27,
    "34": 14,
    "71": 11,
    "69": 14,
    "47": 16,
    "7": 6,
    "39": 18,
    "122": 6,
    "67": 30,
    "84": 7,
    "30": 11,
    "22": 14,
    "104": 9,
    "76": 8,
    "93": 9,
    "46": 12,
    "42": 34,
    "87": 7,
    "89": 7,
    "35": 16,
    "114": 3,
    "110": 9,
    "26": 13,
    "37": 14,
    "79": 7
  }
}